alain	aa ll in
ani	aa nn ii
bacha	bb aa ch aa
bachu	bb aa ch uu
bafu	bb aa ff uu
bagru	bb aa gg rr uu
bahien	bb aa yy in
baillan	bb aa yy an
bainba	bb in bb aa
bainli	bb in ll ii
bakjam	bb aa kk jj aa mm
bakou	bb aa kk ou
baldu	bb aa ll dd uu
baltin	bb aa ll tt in
baltou	bb aa ll tt ou
bango	bb an gg au
bani	bb aa nn ii
banja	bb an jj aa
banlan	bb an ll an
bano	bb aa nn au
banpu	bb an pp uu
bantu	bb an tt ou
barnum	bb aa rr nn oo mm
barta	bb aa rr tt aa
bassu	bb aa ss uu
basti	bb aa ss tt ii
baveu	bb aa vv eu
bavran	bb aa vv rr an
bernan	bb ai rr nn an
berti	bb ai rr tt ii
bessi	bb ei ss ii
beuna	bb eu nn aa
beuva	bb eu vv aa
beuveu	bb eu vv eu
beuv�ne	bb eu vv ai nn
bienron	bb yy in rr on
biensan	bb yy in ss an
bienvin	bb yy in vv in
bienvu	bb yy in vv uu
bierbi	bb yy ai rr bb ii
biervou	bb yy ai rr vv ou
bikan	bb ii kk an
bimin	bb ii mm in
binba	bb in bb aa
binbin	bb in bb in
binfin	bb in ff in
binfu	bb in ff uu
biniou	bb ii nn yy ou
binju	bb in jj uu
binli	bb in ll ii
binlu	bb in ll uu
binpspi	bb in pp ss pp ii
binri	bb in rr ii
binro	bb in rr au
bintrain	bb in tt rr in
bintrin	bb in tt rr in
binzu	bb in zz uu
bipeu	bb ii pp eu
biskin	bb ii ss kk in
bivo	bb ii vv au
bivour	bb ii vv ou rr
bivro	bb ii vv rr au
blafi	bb ll aa ff ii
blairjou	bb ll ai rr jj ou
blalo	bb ll aa ll au
blancsou	bb ll an kk ss ou
blandra	bb ll an dd rr aa
blangzu	bb ll an gg zz uu
blaniz	bb ll aa nn ii
blankin	bb ll an kk in
blanksou	bb ll an kk ss ou
blanti	bb ll an tt ii
bleka	bb ll ee kk aa
blerou	bb ll ee rr ou
bleunum	bb ll eu nn oo mm
bleuva	bb ll eu vv aa
blicha	bb ll ii ch aa
blija	bb ll ii jj aa
blimin	bb ll ii mm in
blinhin	bb ll ii nn in
blinlan	bb ll in ll an
blinrin	bb ll in rr in
blinvam	bb ll in vv aa mm
blipo	bb ll ii pp au
bli�fou	bb ll ii yy ei ff ou
bli�rou	bb ll ii yy ei rr ou
blouchin	bb ll ou ch in
bloulan	bb ll ou ll an
blouptin	bb ll ou pp tt in
bloussi	bb ll ou ss ii
blovri	bb ll oo vv rr ii
bluba	bb ll uu bb aa
bluchi	bb ll uu ch ii
bluko	bb ll uu kk au
blulu	bb ll uu ll uu
blunou	bb ll uu nn ou
blunu	bb ll uu nn uu
blusu	bb ll uu zz uu
bl�du	bb ll ei dd uu
bl�ja	bb ll ei jj aa
bl�pu	bb ll ei pp uu
bl�rin	bb ll ei rr in
bl�rnan	bb ll ei rr nn an
bl�tu	bb ll ei tt uu
bochan	bb oo ch an
bojou	bb oo jj ou
bonia	bb oo nn yy aa
bonskin	bb on ss kk in
bontran	bb on tt rr an
bopou	bb oo pp ou
bortu	bb oo rr tt uu
borvi	bb oo rr vv ii
boskin	bb oo ss kk in
boubo	bb ou bb au
boucha	bb ou ch aa
boufin	bb ou ff in
boumin	bb ou mm in
boumou	bb ou mm ou
bozo	bb oo zz au
braheu	bb rr aa eu
braillin	bb rr aa yy in
brambou	bb rr an bb ou
bramo	bb rr aa mm au
brampsi	bb rr an pp ss ii
brana	bb rr aa nn aa
branbou	bb rr an bb ou
branbru	bb rr an bb rr uu
brandin	bb rr an dd in
branlta	bb rr an ll tt aa
branlu	bb rr an ll uu
branpsi	bb rr an pp ss ii
brantu	bb rr an tt uu
brarjam	bb rr aa rr jj aa mm
brarno	bb rr aa rr nn au
braru	bb rr aa rr uu
bravjunp	bb rr aa vv jj un pp
brayi	bb rr ai yy ii
brayou	bb rr ai yy ou
brenin	bb rr ee nn in
brespan	bb rr ai ss pp an
bretro	bb rr ee tt rr au
brinan	bb rr ii nn an
brincheu	bb rr in ch eu
brincu	bb rr in kk uu
brinfo	bb rr in ff au
brinoua	bb rr ii nn ou aa
brinto	bb rr in tt au
brinvin	bb rr in vv in
bripo	bb rr ii pp au
brobto	bb rr oo bb tt au
brodo	bb rr oo dd au
brolu	bb rr oo ll uu
bropto	bb rr oo pp tt au
brouinio	bb rr ou ii nn yy au
brourvi	bb rr ou rr vv ii
brouti	bb rr ou tt ii
brouva	bb rr ou vv aa
brubin	bb rr uu bb in
bruchin	bb rr uu ch in
brufin	bb rr uu ff in
brufun	bb rr uu ff un
bruku	bb rr uu kk uu
brumu	bb rr uu mm uu
bruna	bb rr uu nn aa
brurssi	bb rr uu rr ss ii
brusa	bb rr uu zz aa
bruspu	bb rr uu ss pp uu
bruta	bb rr uu tt aa
bryem	bb rr yy ai mm
br�di	bb rr ei dd ii
br�ga	bb rr ei gg aa
br�rco	bb rr ei rr kk au
br�van	bb rr ei vv an
bukou	bb uu kk ou
bulu	bb uu ll uu
bumb�m	bb un bb ai mm
buso	bb uu zz au
bussou	bb uu ss ou
buvr�	bb uu vv rr ei
b�rcon	bb ai rr kk on
b�din	bb ei dd in
b�g�	bb ei jj ei
b�hi�	bb ei yy ei
b�iou	bb ei yy ou
b�ji	bb ei jj ii
b�meu	bb ei mm eu
b�nio	bb ei nn yy au
b�pou	bb ei pp ou
b�ro	bb ei rr au
b�rou	bb ei rr ou
b�tu	bb ei tt uu
b�va	bb ei vv aa
b�van	bb ei vv an
b�you	bb ei yy ou
cada	kk aa dd aa
cagnan	kk aa nn yy an
cagui	kk aa gg ii
cahuta	kk aa uu tt aa
camfa	kk an ff aa
camfou	kk an ff ou
camplou	kk an pp ll ou
canfou	kk an ff ou
cangrin	kk an gg rr in
canva	kk an vv aa
canveu	kk an vv eu
cero	ss ee rr au
chadan	ch aa dd an
chaglo	ch aa gg ll au
chaine	ch ai nn
chainta	ch in tt aa
chaji	ch aa jj ii
chaju	ch aa jj uu
chama	ch aa mm aa
chaman	ch aa mm aa nn
chamba	ch an bb aa
chanmo	ch an mm au
chanplou	ch an pp ll ou
chanrgin	ch an rr jj in
chansa	ch an ss aa
chanvin	ch an vv in
charg�m	ch aa rr jj ai mm
charjem	ch aa rr jj ai mm
charli	ch aa rr ll ii
charou	ch aa rr ou
charvan	ch aa rr vv an
charvi	ch aa rr vv ii
chava	ch aa vv aa
chekan	ch ee kk an
chemka	ch an kk aa
chemu	ch ee mm uu
chenca	ch an kk aa
cheniz	ch ee nn ii
cherche	ch ai rr ch ee
cherkin	ch ai rr kk in
chessan	ch ei ss an
cheuchem	ch eu ch ai mm
cheuch�m	ch eu ch ai mm
cheuga	ch eu gg aa
cheumu	ch eu mm uu
cheupu	ch eu pp uu
chev�	ch ee vv ei
chiba	ch ii bb aa
chicha	tt ch ii tt ch aa
chidi	ch ii dd ii
chigan	ch ii gg an
chignan	ch ii nn yy an
chiju	ch ii jj uu
chindan	ch in dd an
chiniam	ch ii nn yy aa mm
chinji	ch in jj ii
chinjo	ch in jj au
chinju	ch in jj uu
chinlou	ch in ll ou
chinta	ch in tt aa
chinten	ch in tt ai nn
chinvi	ch in vv ii
chipli	ch ii pp ll ii
chipso	ch ii pp ss au
chircha	ch ii rr ch aa
chirsa	ch ii rr ss aa
chivou	ch ii vv ou
chkabin	kk kk aa bb in
chobu	ch oo bb uu
chocro	ch oo kk rr au
chodan	ch oo dd an
chofra	ch oo ff rr aa
chofu	ch oo ff uu
choja	ch oo jj aa
cholan	kk oo ll an
chomo	ch oo mm au
chona	ch oo nn aa
choni	ch oo nn ii
chonia	ch oo nn yy aa
choti	ch oo tt ii
chotin	ch oo tt in
chouchu	ch ou ch uu
chouillan	ch ou yy an
choumi	ch ou mm ii
chouran	ch ou rr an
chouro	ch ou rr au
choussi	ch ou ss ii
chov�	ch oo vv ei
chubra	ch uu bb rr aa
chuchu	ch uu ch uu
chucsin	ch uu kk ss in
chudin	ch uu dd in
chudou	ch uu dd ou
chudun	ch uu dd un
chufrin	ch uu ff rr in
chuga	ch uu gg aa
chujchi�m	ch uu jj ch yy ai mm
chuksin	ch uu kk ss in
chuna	ch uu nn aa
chupa	ch uu pp aa
chuto	ch uu tt au
chuvi	ch uu vv ii
chuvin	ch uu vv in
ch�bi	ch ei bb ii
ch�ch�me	ch ei ch ai mm
ch�ien	ch ei yy in
ch�ja	ch ei jj aa
ch�ka	ch ei kk aa
ch�ko	ch ei kk au
ch�lieu	ch ei ll yy eu
ch�lou	ch ei ll ou
ch�ro	ch ei rr au
ch�ssan	ch ei ss an
ch�yeu	ch ei yy eu
ch�za	ch ei zz aa
ch�zam	ch ei zz aa mm
cifam	ss ii ff aa mm
clachin	kk ll aa ch in
clafle	kk ll aa ff ll
clajo	kk ll aa jj au
clanchou	kk ll an ch ou
clanfin	kk ll an ff in
clanki	kk ll an kk ii
clanlo	kk ll an ll au
clanva	kk ll an vv aa
clanvo	kk ll an vv au
clapru	kk ll aa pp rr uu
clarbi	kk ll aa rr bb ii
clarkin	kk ll aa rr kk in
clefs�m	kk ll ai ff ss ai mm
clerbi	kk ll ai rr bb ii
clerkin	kk ll ai rr kk in
clermin	kk ll ai rr mm in
clerno	kk ll ai rr nn au
clevou	kk ll ee vv ou
clichu	kk ll ii ch uu
cliclon	kk ll ii kk ll on
clifin	kk ll ii ff in
clifu	kk ll ii ff uu
cliguin	kk ll ii gg in
clihin	kk ll yy in
clija	kk ll ii jj aa
climin	kk ll ii mm in
clinri	kk ll in rr ii
clinvo	kk ll in vv au
clirpi	kk ll ii rr pp ii
cliti	kk ll ii tt ii
clitou	kk ll ii tt ou
clochu	kk ll oo ch uu
clom�m	kk ll oo mm ai mm
clonou	kk ll oo nn ou
clopu	kk ll oo pp uu
cloufa	kk ll ou ff aa
clouka	kk ll ou kk aa
clousou	kk ll ou zz ou
clouti	kk ll ou tt ii
clugu	kk ll uu gg uu
clurtu	kk ll uu rr tt uu
cl�bla	kk ll ei bb ll aa
cl�ga	kk ll ei gg aa
cl�pin	kk ll ei pp in
cl�zou	kk ll ei zz ou
cocho	kk oo ch au
cocsa	kk oo kk ss aa
coglou	kk oo gg ll ou
combin	kk on bb in
corji	kk oo rr jj ii
cossin	kk oo ss in
coudou	kk ou dd ou
coufin	kk ou ff in
couga	kk ou gg aa
cougain	kk ou gg in
coumou	kk ou mm ou
counia	kk ou nn yy aa
coupu	kk ou pp uu
coup�	kk ou pp ei
courpin	kk ou rr pp in
couzo	kk ou zz au
covin	kk oo vv in
cradra	kk rr aa dd rr aa
craguan	kk rr aa gg ww an
crajin	kk rr aa jj in
cranfa	kk rr an ff aa
cranlu	kk rr an ll uu
cranu	kk rr aa nn uu
craski	kk rr aa ss kk ii
crayo	kk rr ai yy au
creptou	kk rr ai pp tt ou
creveri	kk rr ee vv ee rr ii
criernou	kk rr yy ai rr nn ou
crilo	kk rr ii ll au
crindi	kk rr in dd ii
cringin	kk rr in jj in
crinlin	kk rr in ll in
crinmeu	kk rr in mm eu
crinvou	kk rr in vv ou
criri	kk rr ii rr ii
crita	kk rr ii tt aa
criya	kk rr ii yy aa
crobin	kk rr oo bb in
crobrin	kk rr oo bb rr in
crofin	kk rr oo ff in
crogra	kk rr oo gg rr aa
crouflou	kk rr ou ff ll ou
crutan	kk rr uu tt an
crutri	kk rr uu tt rr ii
cr�cho	kk rr ei ch au
cr�mu	kk rr ei mm uu
cr�ni	kk rr ei nn ii
cr�po	kk rr ei pp au
cr�veu	kk rr ei vv eu
cr�vrin	kk rr ei vv rr in
cuchou	kk uu ch ou
cunon	kk uu nn on
curba	kk uu rr bb aa
c�plan	ss ei pp ll an
dachou	dd aa ch ou
dafa	dd aa ff aa
dagna	dd aa nn yy aa
daki	dd aa kk ii
dalta	dd aa ll tt aa
dampin	dd an pp in
danda	dd an dd aa
danfin	dd an ff in
dangro	dd an gg rr au
danian	dd aa nn yy an
danin	dd aa nn in
danjou	dd an jj ou
danlu	dd an ll uu
danru	dd an rr uu
danski	dd an ss kk ii
danton	dd an tt on
dapo	dd aa pp au
dapun	dd aa pp un
darkin	dd aa rr kk in
daro	dd aa rr au
darti	dd aa rr tt ii
datem	dd aa tt ai mm
davin	dd aa vv in
defi	dd ee ff ii
denbru	dd an bb rr uu
denbu	dd an bb uu
denpin	dd an pp in
denvru	dd an vv rr uu
derin	dd ee rr in
devan	dd ee vv an
dibru	dd ii bb rr uu
dicha	dd ii ch aa
dichim	dd ii ch ii mm
dich�m	dd ii ch ai mm
didi	dd ii dd ii
difa	dd ii ff aa
difi	dd ii ff ii
digna	dd ii nn yy aa
digneu	dd ii nn yy eu
dignou	dd ii nn yy ou
dillou	dd ii yy ou
dilu	dd ii ll uu
dimbro	dd in bb rr au
dimu	dd ii mm uu
dinblin	dd in bb ll in
dinbro	dd in bb rr au
dinchin	dd in ch in
dincho	dd in ch au
dindra	dd in dd rr aa
dindro	dd in dd rr au
dinia	dd ii nn yy aa
dinieu	dd ii nn yy eu
dinjo	dd in jj au
dinli	dd in ll ii
dinri	dd in rr ii
dinro	dd in rr au
dinssu	dd in ss uu
dinta	dd in tt aa
dinu	dd ii nn uu
diouza	dd yy ou zz aa
diouzeur	dd yy ou zz oe rr
dipa	dd ii pp aa
dirillo	dd ii rr ii ll au
dirmou	dd ii rr mm ou
diyou	dd ii yy ou
diyu	dd ii yy uu
djafli	dd jj aa ff ll ii
djama	dd jj aa mm aa
djufa	dd jj uu ff aa
dochi	dd oo ch ii
dochu	dd oo ch uu
dofou	dd oo ff ou
dogzan	dd oo gg zz an
dormi	dd oo rr mm ii
doron	dd oo rr on
dotan	dd oo tt an
dotmo	dd oo tt mm au
dotour	dd oo tt ou rr
doursa	dd ou rr ss aa
dovo	dd oo vv au
dovri	dd oo vv rr ii
doxan	dd oo ss an
drachi	dd rr aa ch ii
dralou	dd rr aa ll ou
dramin	dd rr aa mm in
drancu	dd rr an kk uu
drandin	dd rr an dd in
dranrou	dd rr an rr ou
drapro	dd rr aa pp rr au
drarou	dd rr aa rr ou
drati	dd rr aa tt ii
dratro	dd rr aa tt rr au
dreia	dd rr ai aa
drejou	dd rr ee jj ou
dremju	dd rr an jj uu
drencu	dd rr an kk uu
drespan	dd rr ai ss pp an
drichta	dd rr ii kk tt aa
drigrou	dd rr ii gg rr ou
drinlou	dd rr in ll ou
drirdou	dd rr ii rr dd ou
drisi	dd rr ii zz ii
drisil	dd rr ii zz ii ll
driyo	dd rr ii yy au
droblo	dd rr oo bb ll au
droirku	dd rr ww aa rr kk uu
dronblon	dd rr on bb ll on
dronla	dd rr on ll aa
dronon	dd rr oo nn on
drouji	dd rr ou jj ii
drouko	dd rr ou kk au
drudan	dd rr uu dd an
drullo	dd rr uu ll au
drulti	dd rr uu ll tt ii
druva	dd rr uu vv aa
dr�mju	dd rr ai mm jj uu
dr�cl�	dd rr ei kk ll ei
dr�dr�ne	dd rr ei dd rr ai nn
dubar	dd uu bb aa rr
dubin	dd uu bb in
duchu	dd uu ch uu
dufam	dd uu ff aa mm
duham	dd uu aa mm
dukeu	dd uu kk eu
dumpam	dd un pp aa mm
dunki	dd un kk ii
durou	dd uu rr ou
dutu	dd uu tt uu
duveu	dd uu vv eu
duvru	dd uu vv rr uu
d�psu	dd ai pp ss uu
d�brun	dd ei bb rr un
d�keu	dd ei kk eu
d�mo	dd ei mm au
d�nian	dd ei nn yy an
d�psu	dd ei pp ss uu
euveu	eu vv eu
fadri	ff aa dd rr ii
fafa	ff aa ff aa
fafeu	ff aa ff eu
fagle	ff aa gg ll ee
faji	ff aa jj ii
fallu	ff aa ll uu
fama	ff aa mm aa
fameu	ff aa mm eu
famku	ff an kk uu
famptu	ff an pp tt uu
fanfro	ff an ff rr au
fania	ff aa nn yy aa
fanjin	ff an jj in
fanzin	ff an zz in
fapro	ff aa pp rr au
farcheu	ff aa rr ch eu
farci	ff aa rr ss ii
farmu	ff aa rr mm uu
fava	ff aa vv aa
faveu	ff aa vv eu
favin	ff aa vv in
favran	ff aa vv rr an
favrant	ff aa vv rr an
fedou	ff ee dd ou
fenptu	ff an pp tt uu
fensin	ff an ss in
fenzin	ff an zz in
ferkseu	ff ai rr kk ss eu
fersin	ff ai rr ss in
fervu	ff ai rr vv uu
fesu	ff ee zz uu
feuch�	ff eu ch ei
feufi	ff eu ff ii
feufin	ff eu ff in
feuheu	ff eu eu
feuhin	ff eu in
feuhum	ff eu oo mm
feuhva	ff oe vv aa
feuju	ff eu jj uu
feujum	ff eu jj oo mm
feuma	ff eu mm aa
feunum	ff eu nn oo mm
feuplam	ff eu pp ll aa mm
feuplan	ff eu pp ll an
feuseu	ff eu zz eu
feuva	ff eu vv aa
feuvam	ff eu vv aa mm
feuveu	ff eu vv eu
feuveun	ff eu vv eu nn
feuvin	ff eu vv in
feuvu	ff eu vv uu
feuvum	ff eu vv oo mm
feuwha	ff oe ww aa
feuyeu	ff eu yy eu
fevdi	ff ai vv dd ii
fienti	ff yy an tt ii
fifa	ff ii ff aa
fihum	ff yy oo mm
fija	ff ii jj aa
fima	ff ii mm aa
finchem	ff in ch ai mm
fincho	ff in ch au
fincra	ff in kk rr aa
finfa	ff in ff aa
fingli	ff in gg ll ii
finheu	ff ii nn eu
finhin	ff ii nn in
finin	ff ii nn in
finju	ff in jj uu
finksin	ff in kk ss in
finsa	ff in ss aa
finssi	ff in ss ii
finstu	ff in ss tt uu
finti	ff in tt ii
finto	ff in tt au
finu	ff ii nn uu
finva	ff in vv aa
finveu	ff in vv eu
finvi	ff in vv ii
finviem	ff in vv yy ai mm
finvin	ff in vv in
finvu	ff in vv uu
firpa	ff ii rr pp aa
fissa	ff ii ss aa
fiyu	ff ii yy uu
fi�zan	ff yy ei zz an
flacon	ff ll aa kk on
flactin	ff ll aa kk tt in
flaguin	ff ll aa gg in
flainrain	ff ll in rr in
flalli	ff ll aa ll ii
flanfi	ff ll an ff ii
flango	ff ll an gg au
flaou	ff ll aa ou
flassin	ff ll aa ss in
flato	ff ll aa tt au
flego	ff ll ee gg au
flesku	ff ll ai ss kk uu
flimpru	ff ll in pp rr uu
flinch�m	ff ll in ch ai mm
flinpru	ff ll in pp rr uu
flinrin	ff ll in rr in
flinspou	ff ll in ss pp ou
flinvri	ff ll in vv rr ii
flirjou	ff ll ii rr jj ou
fliu	ff ll ii yy uu
floblan	ff ll oo bb ll an
flonian	ff ll oo nn yy an
flospin	ff ll oo ss pp in
floupsi	ff ll ou pp ss ii
floupsin	ff ll ou pp ss in
flouyen	ff ll ou yy in
flouyin	ff ll ou yy in
fluca	ff ll uu kk aa
fluga	ff ll uu gg aa
flugna	ff ll uu nn yy aa
flugun	ff ll uu gg un
fluka	ff ll uu kk aa
flurmo	ff ll uu rr mm au
flussu	ff ll uu ss uu
flutin	ff ll uu tt in
fluvin	ff ll uu vv in
fluvu	ff ll uu vv uu
fl�gru	ff ll ei gg rr uu
fl�gun	ff ll ei gg un
fl�ji	ff ll ei jj ii
fogu	ff oo gg uu
fonan	ff oo nn an
fonction	ff on kk ss yy on
fopi	ff oo pp ii
fopin	ff oo pp in
forji	ff oo rr jj ii
forki	ff oo rr kk ii
forpin	ff oo rr pp in
fouba	ff ou bb aa
fouglan	ff ou gg ll an
fouplu	ff ou pp ll uu
fouru	ff ou rr uu
fracso	ff rr aa kk ss au
fradan	ff rr aa dd an
frainpu	ff rr in pp uu
franfin	ff rr an ff in
frantou	ff rr an tt ou
frardou	ff rr aa rr dd ou
frebin	ff rr ee bb in
freoua	ff rr ou aa
frerdo	ff rr ai rr dd au
frerdou	ff rr ai rr dd ou
freumu	ff rr eu mm uu
frijou	ff rr ii jj ou
frinbi	ff rr in bb ii
frinfri	ff rr in ff rr ii
frinpu	ff rr in pp uu
frinvo	ff rr in vv au
frinvreu	ff rr in vv rr eu
frirvan	ff rr ii rr vv an
froavin	ff rr oo aa vv in
frochou	ff rr oo ch ou
frofa	ff rr oo ff aa
fronbin	ff rr on bb in
froplu	ff rr oo pp ll uu
fropu	ff rr oo pp uu
frouno	ff rr ou nn au
frovin	ff rr oo vv in
frupo	ff rr uu pp au
frurkin	ff rr uu rr kk in
frurti	ff rr uu rr tt ii
fruvin	ff rr uu vv in
fruzu	ff rr uu zz uu
fr�redo	ff rr ai rr ee dd au
fr�guan	ff rr ei gg an
fr�sou	ff rr ei zz ou
fufi	ff uu ff ii
fufou	ff uu ff ou
fugloum	ff uu gg ll ou mm
fugno	ff uu nn yy au
fugui	ff uu gg ii
fuhin	ff uu in
fuju	ff uu jj uu
fukin	ff uu kk in
fula	ff uu ll aa
fultout	ff uu ll tt ou
ful�m	ff uu ll ei mm
fumin	ff uu mm in
fumka	ff un kk aa
funia	ff uu nn yy aa
furti	ff uu rr tt ii
fusin	ff uu zz in
fusu	ff uu zz uu
fusum	ff uu zz oo mm
fuvin	ff uu vv in
fuvu	ff uu vv uu
f�clou	ff ei kk ll ou
f�feu	ff ei ff eu
f�fin	ff ei ff in
f�glu	ff ei gg ll uu
f�gu	ff ei gg uu
f�iou	ff ei yy ou
f�ju	ff ei jj uu
f�man	ff ei mm an
f�men	ff ei mm ai nn
f�si	ff ei zz ii
f�ssa	ff ei ss aa
gabla	gg aa bb ll aa
gabu	gg aa bb uu
gadji	gg aa dd jj ii
gagnou	gg aa nn yy ou
gagrin	gg aa gg rr in
gaham	gg aa aa mm
gaivo	gg ai vv au
gaiyou	gg ai yy ou
gaja	gg aa jj aa
gajo	gg aa jj au
gamhum	gg an oo mm
gancrin	gg an kk rr in
ganfra	gg an ff rr aa
ganou	gg aa nn ou
gansti	gg an ss tt ii
ganvran	gg an vv rr an
garam	gg aa rr aa mm
garpam	gg aa rr pp aa mm
gavri	gg aa vv rr ii
gazan	gg aa zz an
gerbu	jj ai rr bb uu
germain	jj ai rr mm in
ghat�m	gg aa tt ai mm
ginvin	jj in vv in
girdun	jj ii rr dd un
giu	jj yy uu
gjoulta	gg jj ou ll tt aa
glabru	gg ll aa bb rr uu
glain	gg ll in
glaio	gg ll ai au
glanan	gg ll aa nn an
glansa	gg ll an ss aa
glanti	gg ll an tt ii
glarti	gg ll aa rr tt ii
glasu	gg ll aa zz uu
glayo	gg ll ai yy au
glbru	gg ll bb rr uu
glekou	gg ll ee kk ou
glempo	gg ll an pp au
gleudru	gg ll eu dd rr uu
gliga	gg ll ii gg aa
gligua	gg ll ii gg aa
glihia	gg ll ii yy aa
glinpo	gg ll in pp au
glinrpin	gg ll in rr pp in
glisan	gg ll ii zz an
glizan	gg ll ii zz an
glomin	gg ll oo mm in
glora	gg ll oo rr aa
glor�	gg ll oo rr ei
gloucra	gg ll ou kk rr aa
gloudi	gg ll ou dd ii
glouji	gg ll ou jj ii
gloulu	gg ll ou ll uu
gloupu	gg ll ou pp uu
glouru	gg ll ou rr uu
glouson	gg ll ou zz on
glouvi	gg ll ou vv ii
glubri	gg ll uu bb rr ii
glugan	gg ll uu gg an
gluha	gg ll uu aa
glukou	gg ll uu kk ou
glumou	gg ll uu mm ou
glupin	gg ll uu pp in
glura	gg ll uu rr aa
glurun	gg ll uu rr un
gl�nan	gg ll ei nn an
gnaiou	gg nn ai ou
gnangsan	gg nn an gg ss an
gnatran	gg nn aa tt rr an
gna�da	gg nn aa ei dd aa
gnidu	gg nn ii dd uu
gnignan	gg nn ii nn yy an
gniha	gg nn ii aa
gnimu	gg nn ii mm uu
gnocru	gg nn oo kk rr uu
gnono	gg nn oo nn au
gnoucro	gg nn ou kk rr au
gnouden	gg nn ou dd ai nn
gnoumi	gg nn ou mm ii
gnouzan	gg nn ou zz an
gofo	gg oo ff au
gognan	gg oo nn yy an
gogsi	gg oo gg ss ii
gona	gg oo nn aa
gonfian	gg on ff yy an
gorqui	gg oo rr kk ii
gotrin	gg oo tt rr in
gouchi	gg ou ch ii
goudou	gg ou dd ou
goufian	gg ou ff yy an
goukan	gg ou kk an
gounour	gg ou nn ou rr
goupson	gg ou pp ss on
gourjan	gg ou rr jj an
govrin	gg oo vv rr in
gracou	gg rr aa kk ou
gractou	gg rr aa kk tt ou
graga	gg rr aa gg aa
graheu	gg rr aa eu
graimpso	gg rr in pp ss au
grainla	gg rr in ll aa
graji	gg rr aa jj ii
grajo	gg rr aa jj au
grajou	gg rr aa jj ou
graman	gg rr aa mm an
grampso	gg rr an pp ss au
granchin	gg rr an ch in
granchu	gg rr an ch uu
granrno	gg rr an rr nn au
gransan	gg rr an ss an
gravclan	gg rr aa vv kk ll an
grespou	gg rr ai ss pp ou
greuchu	gg rr eu ch uu
griba	gg rr ii bb aa
gribo	gg rr ii bb au
grichu	gg rr ii ch uu
grictan	gg rr ii kk tt an
grignon	gg rr ii nn yy on
grillon	gg rr ii yy on
grincro	gg rr in kk rr au
grinsu	gg rr in ss uu
grinvin	gg rr in vv in
gripi	gg rr ii pp ii
grispi	gg rr ii ss pp ii
gristu	gg rr ii ss tt uu
grita	gg rr ii tt aa
gritrin	gg rr ii tt rr in
grivi	gg rr ii vv ii
grivra	gg rr ii vv rr aa
grobu	gg rr oo bb uu
grochou	gg rr oo ch ou
grorno	gg rr oo rr nn au
grosnou	gg rr oo ss nn ou
grougrou	gg rr ou gg rr ou
grouman	gg rr ou mm an
grucou	gg rr uu kk ou
grugou	gg rr uu gg ou
grultin	gg rr uu ll tt in
grunchu	gg rr un ch uu
gr�ta	gg rr ei tt aa
guanbin	gg an bb in
guangrin	gg an gg rr in
guanprin	gg an pp rr in
guba	gg uu bb aa
gubru	gg uu bb rr uu
guchu	gg uu ch uu
gueilla	gg oe yy aa
gueniou	gg nn yy ou
guerin	gg rr in
guermo	gg ai rr mm au
guerpin	gg ai rr pp in
guerpou	gg ai rr pp ou
gugnon	gg uu nn yy on
gugnou	gg uu nn yy ou
gugon	gg uu gg on
gugrin	gg uu gg rr in
gugru	gg uu gg rr uu
guiblin	gg ii bb ll in
guibtou	gg ii bb tt ou
guichan	gg ii ch an
guifi	gg ii ff ii
guiga	gg ii gg aa
guigham	gg ii gg aa mm
guinclo	gg in kk ll au
guinfi	gg in ff ii
guinsrou	gg in ss rr ou
guinsu	gg in ss uu
guinzin	gg in zz in
guirtou	gg ii rr tt ou
guiyu	gg ii yy uu
gui�flu	gg yy ei ff ll uu
gujam	gg uu jj aa mm
gujem	gg uu jj ai mm
gunin	gg uu nn in
gupl�m	gg uu pp ll ai mm
gupl�m	gg uu pp ll ei mm
gupru	gg uu pp rr uu
gurda	gg uu rr dd aa
guri	gg uu rr ii
gu�din	gg ei dd in
gu�guin	gg ei gg in
gu�mo	gg ei mm au
gu�pan	gg ei pp an
gu�qui	gg ei kk ii
gu�vo	gg ei vv au
gu�you	gg ei yy ou
g�jeu	jj ei jj eu
hamglu	an gg ll uu
harbou	aa rr bb ou
hargue	aa rr gg ee
hencu	an kk uu
herfeu	ai rr ff eu
hermin	ai rr mm in
hersu	ai rr ss uu
heuama	eu aa mm aa
heufeu	eu ff eu
heuha	eu aa
heuma	eu mm aa
heumain	eu mm in
heumeu	eu mm eu
heupeu	eu pp eu
heurfeu	oe rr ff eu
heurvin	oe rr vv in
heusu	eu zz uu
heuveu	eu vv eu
heuvin	eu vv in
heuvu	eu vv uu
heu�vfeu	eu ai vv ff eu
hibl�	ii bb ll ei
hibri	ii bb rr ii
hienp�n	ii an pp ai nn
hikeum	ii kk eu mm
hinfin	in ff in
hipu�	ii pp uu ei
hiurgou	yy uu rr gg ou
hugui	uu gg ii
humain	uu mm in
humin	uu mm in
humvu	un vv uu
hundam	un dd aa mm
h�y�m	ai yy ai mm
h�feu	ei ff eu
h�f�m	ei ff ai mm
h�zi�m	ei zz yy ai mm
iadu	yy aa dd uu
iafrin	yy aa ff rr in
iafro	yy aa ff rr au
iago	yy aa gg au
ialnian	yy aa ll nn yy an
ialu	yy aa ll uu
iandro	yy an dd rr au
iango	yy an gg au
iani	yy aa nn ii
ianksu	yy an kk ss uu
iansan	yy an ss an
iansin	yy an ss in
ianu	yy aa nn uu
iasu	yy aa zz uu
iatin	yy aa tt in
iatrin	yy aa tt rr in
idor	ii dd oo rr
ienkeu	ii an kk eu
ienrbo	ii an rr bb au
iento	ii an tt au
ienvu	ii an vv uu
ierjo	ii ai rr jj au
iessi	ii ei ss ii
iobin	yy oo bb in
iopta	yy oo pp tt aa
iorvu	yy oo rr vv uu
ioulou	yy ou ll ou
ioupin	yy ou pp in
iournu	yy ou rr nn uu
iouska	yy ou ss kk aa
iovo	yy oo vv au
iovu	yy oo vv uu
iuglu	yy uu gg ll uu
iurta	yy uu rr tt aa
i�ntkeu	yy ai nn tt kk eu
i�do	yy ei dd au
i�guan	yy ei gg an
i�j�	yy ei jj ei
i�kssu	yy ei kk ss uu
i�lia	yy ei ll yy aa
i�nio	yy ei nn yy au
i�niou	yy ei nn yy ou
i�rin	yy ei rr in
i�ssou	yy ei ss ou
i�va	yy ei vv aa
jachu	jj aa ch uu
jaillan	jj aa yy an
jajou	jj aa jj ou
janchi	jj an ch ii
janeu	jj aa nn eu
janfran	jj an ff rr an
janin	jj aa nn in
janjin	jj an jj in
janran	jj an rr an
janrtin	jj an rr tt in
jansan	jj an ss an
jarbo	jj aa rr bb au
jarn	jj aa rr nn ee
jarpin	jj aa rr pp in
jarpu	jj aa rr pp uu
jarto	jj aa rr tt au
javeu	jj aa vv eu
jayun	jj ai yy un
jedan	jj ee dd an
jenpi	jj an pp ii
jenran	jj an rr an
jenrtin	jj an rr tt in
jepeu	jj ee pp eu
jeukeu	jj eu kk eu
jeveu	jj ee vv eu
jibi	jj ii bb ii
jicha	jj ii ch aa
jicheu	jj ii ch eu
jico	jj ii kk au
jido	jj ii dd au
jidou	jj ii dd ou
jifri	jj ii ff rr ii
jikan	jj ii kk an
jikta	jj ii kk tt aa
jila	jj ii ll aa
jimpa	jj in pp aa
jindrin	jj in dd rr in
jinpa	jj in pp aa
jinu	jj ii nn uu
jinvin	jj in vv in
jiplou	jj ii pp ll ou
jipou	jj ii pp ou
jira	jj ii rr aa
jirdin	jj ii rr dd in
jirta	jj ii rr tt aa
jissan	jj ii ss an
jita	jj ii tt aa
jitrin	jj ii tt rr in
jitu	jj ii tt uu
joflan	jj oo ff ll an
jofli	jj oo ff ll ii
jogin	jj oo jj in
jojin	jj oo jj in
jolin	jj oo ll in
jorgin	jj oo rr jj in
jorhin	jj oo rr in
jorn�r	jj oo rr nn ai rr
jorn�	jj oo rr nn ei
josa	jj oo zz aa
joubin	jj ou bb in
joufeu	jj ou ff eu
jouflan	jj ou ff ll an
joufu	jj ou ff uu
jouju	jj ou jj uu
joukan	jj ou kk an
joula	jj ou ll aa
jounien	jj ou nn yy in
joupta	jj ou pp tt aa
jourja	jj ou rr jj aa
jourmi	jj ou rr mm ii
jouro	jj ou rr au
joursin	jj ou rr ss in
jouvi	jj ou vv ii
jouvin	jj ou vv in
jtoctu	jj tt oo kk tt uu
jubu	jj uu bb uu
juda	jj uu dd aa
judrou	jj uu dd rr ou
jufin	jj uu ff in
jugneu	jj uu nn yy eu
jugnon	jj uu nn yy on
juka	jj uu kk aa
jumkeu	jj un kk eu
junin	jj uu nn in
jursu	jj uu rr ss uu
jusseu	jj uu ss eu
ju�di	jj uu ei dd ii
j�cho	jj ei ch au
j�mal	jj ei mm aa ll
j�zin	jj ei zz in
kagnan	kk aa nn yy an
kagui	kk aa gg ii
kamva	kk an vv aa
kanfrou kk an ff rr ou
kanrji	kk an rr jj ii
kanvan	kk an vv an
kanzu	kk an zz uu
kardo	kk aa rr dd au
keksou	kk ee kk ss ou
kembu	kk an bb uu
kemja	kk an jj aa
kenvin	kk an vv in
kersu	kk ai rr ss uu
kessa	kk ei ss aa
kesso	kk ei ss au
keumem	kk eu mm ai mm
keumou	kk eu mm ou
kevi	kk ee vv ii
kiabou	kk yy aa bb ou
kian	kk yy an
kichu	kk ii ch uu
kidan	kk ii dd an
kiden	kk ii dd ai nn
kigna	kk ii nn yy aa
kigno	kk ii nn yy au
kignou	kk ii nn yy ou
kinchin	kk in ch in
kindu	kk in dd uu
kinha	kk ii nn aa
kinio	kk ii nn yy au
kioufa	kk yy ou ff aa
kiouron	kk yy ou rr on
kipa	kk ii pp aa
kitrou	kk ii tt rr ou
kivo	kk ii vv au
klapru	kk ll aa pp rr uu
klik�m	kk ll ii kk ai mm
klimpa	kk ll in pp aa
klirpi	kk ll ii rr pp ii
klissan	kk ll ii ss an
klitam	kk ll ii tt aa mm
klopu	kk ll oo pp uu
klouka	kk ll ou kk aa
klugu	kk ll uu gg uu
kl�zou	kk ll ei zz ou
kofo	kk oo ff au
kogou	kk oo gg ou
korio	kk oo rr yy au
kouja	kk ou jj aa
koumou	kk ou mm ou
kouzo	kk ou zz au
kralan	kk rr aa ll an
kranvu	kk rr an vv uu
kreuku	kk rr eu kk uu
kriblo	kk rr ii bb ll au
krogra	kk rr oo gg rr aa
krouvi	kk rr ou vv ii
kr�ni	kk rr ei nn ii
kuchou	kk uu ch ou
kuda	kk uu dd aa
kufeu	kk uu ff eu
kufu	kk uu ff uu
kuji	kk uu jj ii
kulmu	kk uu ll mm uu
kumkon	kk un kk on
kumu	kk uu mm uu
kuniou	kk uu nn yy ou
kurba	kk uu rr bb aa
kutin	kk uu tt in
kutri	kk uu tt rr ii
k�mfta	kk ai mm ff tt aa
k�ki	kk ei kk ii
k�nan	kk ei nn an
k�nen	kk ei nn ai nn
k�niane	kk ei nn yy aa nn
k�pon	kk ei pp on
k�pou	kk ei pp ou
k�sso	kk ei ss au
k�ti	kk ei tt ii
lado	ll aa dd au
lafa	ll aa ff aa
laha	ll aa aa
laja	ll aa jj aa
lalin	ll aa ll in
lampsa	ll an pp ss aa
lam�	ll aa mm ei
lanchin	ll an ch in
lancho	ll an ch au
lanin	ll aa nn in
lanju	ll an jj uu
lanlan	ll an ll an
lanpin	ll an pp in
lapi	ll aa pp ii
leba	ll ee bb aa
lefou	ll ee ff ou
lelo	ll ee ll au
lepsa	ll ee pp ss aa
leps�m	ll ee pp ss ai mm
lersou	ll ai rr ss ou
leru	ll ee rr uu
lespan	ll ai ss pp an
lesso	ll ei ss au
lesspan	ll ai ss ss pp an
leufa	ll eu ff aa
liaien	ll yy ai in
licrou	ll ii kk rr ou
lidin	ll ii dd in
liegu	ll ii gg uu
lienpla	ll yy an pp ll aa
lieran	ll ii rr an
lieuca	ll yy eu kk aa
lieumon	ll yy eu mm on
lieuvfou	ll yy oe vv ff ou
ligan	ll ii gg an
lilla	ll ii yy aa
lilo	ll ii ll au
lilou	ll ii ll ou
limu	ll ii mm uu
lingra	ll in gg rr aa
linhin	ll ii nn in
linhum	ll ii nn oo mm
linju	ll in jj uu
linlo	ll in ll au
linpu	ll in pp uu
linru	ll in rr uu
linsa	ll in ss aa
linssa	ll in ss aa
linti	ll in tt ii
lintru	ll in tt rr uu
lipo	ll ii pp au
litra	ll ii tt rr aa
li�mi	ll yy ei mm ii
li�ssou	ll yy ei ss ou
lochtu	ll oo kk tt uu
lognou	ll oo nn yy ou
lojin	ll oo jj in
loki	ll oo kk ii
loniou	ll oo nn yy ou
lorin	ll oo rr in
lorsin	ll oo rr ss in
lossan	ll oo ss an
loudji	ll ou dd jj ii
loulia	ll ou ll yy aa
loulu	ll ou ll uu
lournan	ll ou rr nn an
lourtin	ll ou rr tt in
louru	ll ou rr uu
loutu	ll ou tt uu
louzia	ll ou zz yy aa
luba	ll uu bb aa
ludin	ll uu dd in
lufa	ll uu ff aa
luflin	ll uu ff ll in
luhum	ll uu oo mm
lujam	ll uu jj aa mm
lumou	ll uu mm ou
luplin	ll uu pp ll in
luplou	ll uu pp ll ou
luvrai	ll uu vv rr ai
l�ra	ll ai rr aa
l�da	ll ei dd aa
l�nu	ll ei nn uu
l�tou	ll ei tt ou
l�va	ll ei vv aa
mabro	mm aa bb rr au
macan	mm aa kk an
macour	mm aa kk ou rr
mafa	mm aa ff aa
mafan	mm aa ff an
mafeu	mm aa ff eu
magui	mm aa gg ii
maindan	mm in dd an
mainju	mm in jj uu
mainklo	mm in kk ll au
mainvin	mm in vv in
maison	mm ai zz on
makan	mm aa kk an
mamro	mm an rr au
manban	mm an bb an
maniou	mm aa nn yy ou
manlo	mm an ll au
manrou	mm an rr ou
manti	mm an tt ii
manva	mm an vv aa
mapa	mm aa pp aa
mapin	mm aa pp in
mapla	mm aa pp ll aa
mapom	mm aa pp on
marpan	mm aa rr pp an
marqueu	mm aa rr kk eu
marvam	mm aa rr vv aa mm
marv�m	mm aa rr vv ai mm
masi	mm aa zz ii
maspam	mm aa ss pp aa mm
maspi	mm aa ss pp ii
mayi	mm ai yy ii
meki	mm ee kk ii
meufou	mm eu ff ou
meuheu	mm eu eu
meuhin	mm eu in
meuleu	mm eu ll eu
meuva	mm eu vv aa
meuveu	mm eu vv eu
meuv�	mm eu vv ei
miclia	mm ii kk ll ii yy aa
mida	mm ii dd aa
mient�n	mm yy an tt ai nn
mieugu	mm yy eu gg uu
mieuza	mm yy eu zz aa
milla	mm ii ll aa
minban	mm in bb an
minchan	mm in ch an
minclo	mm in kk ll au
mincron	mm in kk rr on
minfan	mm in ff an
mingo	mm in gg au
minju	mm in jj uu
minj�m	mm in jj ai mm
minski	mm in ss kk ii
mioula	mm yy ou ll aa
mioutain	mm yy ou tt in
miplou	mm ii pp ll ou
mirchu	mm ii rr ch uu
miria	mm ii rr yy aa
mirsu	mm ii rr ss uu
mistu	mm ii ss tt uu
miunu	mm yy uu nn uu
mi�fu	mm yy ei ff uu
moban	mm oo bb an
mochin	mm oo ch in
mofa	mm oo ff aa
mofi	mm oo ff ii
mogni	mm oo nn yy ii
mogrin	mm oo gg rr in
mogso	mm oo gg ss au
moha	mm oo aa
moipin	mm ww aa pp in
monan	mm oo nn an
moncran	mm on kk rr an
monen	mm oo nn ai nn
monfa	mm on ff aa
monian	mm oo nn yy an
montran	mm on tt rr an
mopra	mm oo pp rr aa
mopru	mm oo pp rr uu
morka	mm oo rr kk aa
morkin	mm oo rr kk in
morna	mm oo rr nn aa
moru	mm oo rr uu
mosi	mm oo zz ii
mossa	mm oo ss aa
mosu	mm oo zz uu
mouchin	mm ou ch in
moucho	mm ou ch au
moucou	mm ou kk ou
moucssin	mm ou kk ss in
moudin	mm ou dd in
moufou	mm ou ff ou
mouga	mm ou gg aa
mouhou	mm ou ou
mouilli	mm ou yy ii
mouilte	mm ou ii ll tt ee
moulou	mm ou ll ou
mounia	mm ou nn yy aa
moupan	mm ou pp an
mouran	mm ou rr an
mour�	mm ou rr ei
mouso	mm ou zz au
mousu	mm ou zz uu
moutro	mm ou tt rr au
mouvo	mm ou vv au
mouvu	mm ou vv uu
mov	mm oo vv
mubain	mm uu bb in
mufen	mm uu ff ai nn
mufin	mm uu ff in
mugna	mm uu nn yy aa
muinou	mm uy ii nn ou
muja	mm uu jj aa
muju	mm uu jj uu
muna	mm uu nn aa
munia	mm uu nn yy aa
murg�m	mm uu rr jj ai mm
murjam	mm uu rr jj aa mm
m�ncrou	mm ai nn kk rr ou
m�nlou	mm ai nn ll ou
m�spam	mm ai ss pp aa mm
m�fan	mm ei ff an
m�va	mm ei vv aa
nabri	nn aa bb rr ii
nafeu	nn aa ff eu
nainfeu	nn in ff eu
najou	nn aa jj ou
naju	nn aa jj uu
namko	nn an kk au
namo	nn aa mm au
nanbu	nn an bb uu
nanca	nn an kk aa
nancho	nn an ch au
nanci	nn an ss ii
nanio	nn aa nn yy au
nanka	nn an kk aa
nanpan	nn an pp an
nanrin	nn an rr in
nantro	nn an tt rr au
nanvan	nn an vv an
napi	nn aa pp ii
napin	nn aa pp in
napto	nn aa pp tt au
naspi	nn aa ss pp ii
naya	nn ai yy aa
nedi	nn ee dd ii
neji	nn ee jj ii
nemou	nn ee mm ou
nempem	nn an pp ai mm
nenbu	nn an bb uu
nendou	nn an dd ou
nenrin	nn an rr in
nenso	nn an ss au
nentrou	nn an tt rr ou
nerpan	nn ai rr pp an
nessa	nn ei ss aa
neufa	nn eu ff aa
niabou	nn yy aa bb ou
niafan	nn yy aa ff an
niagui	nn yy aa gg ii
niaida	nn yy ai dd aa
niaji	nn yy aa jj ii
niaka	nn yy aa kk aa
niala	nn yy aa ll aa
nialan	nn yy aa ll an
niali	nn yy aa ll ii
niallu	nn yy aa ll uu
nialon	nn yy aa ll on
niam	nn yy aa mm
niambou	nn yy an bb ou
niamlo	nn yy an ll au
niamou	nn yy aa mm ou
niamzi	nn yy an zz ii
nian	nn yy an
nianbon	nn yy an bb on
niando	nn yy an dd au
niangru	nn yy an gg rr uu
nianksa	nn yy an kk ss aa
nianpi	nn yy an pp ii
nianri	nn yy an rr ii
nianrli	nn yy an rr ll ii
niansku	nn yy an ss kk uu
nianti	nn yy an tt ii
niapan	nn yy aa pp an
niassi	nn yy aa ss ii
niasso	nn yy aa ss au
niasu	nn yy aa zz uu
nias�	nn yy aa zz ei
niati	nn yy aa tt ii
niatin	nn yy aa tt in
niato	nn yy aa tt au
niatran	nn yy aa tt rr an
niavo	nn yy aa vv au
niayou	nn yy ai yy ou
nibran	nn ii bb rr an
nibrin	nn ii bb rr in
nicha	nn ii ch aa
nicham	nn ii ch aa mm
nichin	nn ii ch in
nidi	nn ii dd ii
niemtem	nn yy an tt ai mm
niena	nn ii nn aa
niendi	nn yy an dd ii
nienfi	nn yy an ff ii
nienglin	nn yy an gg ll in
nierbi	nn yy ai rr bb ii
nierma	nn yy ai rr mm aa
nieufu	nn yy eu ff uu
nifa	nn ii ff aa
nifi	nn ii ff ii
nihin	nn yy in
niho	nn yy au
nihu	nn yy uu
nimagla	nn ii mm aa gg ll aa
nimpan	nn in pp an
nimu	nn ii mm uu
nina	nn ii nn aa
ninchi	nn in ch ii
ninchu	nn in ch uu
nindou	nn in dd ou
ninfi	nn in ff ii
ninfrou	nn in ff rr ou
ninfru	nn in ff rr uu
ninfu	nn in ff uu
ninhin	nn ii nn in
nini	nn ii nn ii
ninja	nn in jj aa
ninjem	nn in jj ai mm
ninli	nn in ll ii
nino	nn ii nn au
ninsou	nn in ss ou
ninzan	nn in zz an
niocla	nn yy oo kk ll aa
niocru	nn yy oo kk rr uu
niomo	nn yy oo mm au
niomu	nn yy oo mm uu
niono	nn yy oo nn au
nionu	nn yy oo nn uu
nionvi	nn yy on vv ii
niopla	nn yy oo pp ll aa
nioprin	nn yy oo pp rr in
niou	nn yy ou
nioucou	nn yy ou kk ou
nioucro	nn yy ou kk rr au
nioudan	nn yy ou dd an
niouflin	nn yy ou ff ll in
niouku	nn yy ou kk uu
nioultant	nn yy ou ll tt an
nioultou	nn yy ou ll tt ou
niouman	nn yy ou mm an
nioumen	nn yy ou mm ai nn
nioumi	nn yy ou mm ii
nioumu	nn yy ou mm uu
niouno	nn yy ou nn au
nioupa	nn yy ou pp aa
niouprin	nn yy ou pp rr in
nioupu	nn yy ou pp uu
niourin	nn yy ou rr in
niourmu	nn yy ou rr mm uu
nioustu	nn yy ou ss tt uu
nioutin	nn yy ou tt in
niouvu	nn yy ou vv uu
niouzin	nn yy ou zz in
niovi	nn yy oo vv ii
nipan	nn ii pp an
nipeu	nn ii pp eu
nisin	nn ii zz in
nisme	nn ii ss mm ee
nissa	nn ii ss aa
nitan	nn ii tt an
nitin	nn ii tt in
nito	nn ii tt au
niuji	nn yy uu jj ii
niujour	nn yy uu jj ou rr
niupa	nn yy uu pp aa
niurkan	nn yy uu rr kk an
nivu	nn ii vv uu
niya	nn ii yy aa
nizou	nn ii zz ou
ni�bi	nn yy ei bb ii
ni�di	nn yy ei dd ii
ni�do	nn yy ei dd au
ni�fa	nn yy ei ff aa
ni�jo	nn yy ei jj au
ni�lu	nn yy ei ll uu
ni�nou	nn yy ei nn ou
ni�ssa	nn yy ei ss aa
nocho	nn oo ch au
nochu	nn oo ch uu
nolu	nn oo ll uu
nonia	nn oo nn yy aa
nonou	nn oo nn ou
nordu	nn oo rr dd uu
norin	nn oo rr in
norssi	nn oo rr ss ii
nosclin	nn oo ss kk ll in
noufrou	nn ou ff rr ou
noujou	nn ou jj ou
nouli	nn ou ll ii
nounan	nn ou nn an
nourma	nn ou rr mm aa
nouva	nn ou vv aa
nouvran	nn ou vv rr an
nouvu	nn ou vv uu
nuaji	nn uu aa jj ii
nubam	nn uu bb aa mm
nubin	nn uu bb in
nufin	nn uu ff in
nufli	nn uu ff ll ii
nufon	nn uu ff on
nuirban	nn uy ii rr bb an
numain	nn uu mm in
numi	nn uu mm ii
nuna	nn uu nn aa
nuou	nn uu ou
nuro	nn uu rr au
nustan	nn uu ss tt an
nusu	nn uu zz uu
nutin	nn uu tt in
nyilu	nn yy ii ll uu
n�mp�n	nn ai mm pp ai nn
n�ba	nn ei bb aa
n�di	nn ei dd ii
n�feu	nn ei ff eu
n�ma	nn ei mm aa
n�man	nn ei mm an
n�men	nn ei mm ai nn
n�sen	nn ei zz ai nn
n�ssem	nn ei ss ai mm
n�tan	nn ei tt an
n�ten	nn ei tt ai nn
n�va	nn ei vv aa
n�ya	nn ei yy aa
n�chu	nn au ch uu
oclin	oo kk ll in
ofrou	oo ff rr ou
oui	ww ii
ou�r�	ou ei rr ei
pafa	pp aa ff aa
pafeu	pp aa ff eu
paha	pp aa aa
painfeu	pp in ff eu
painla	pp in ll aa
painveu	pp in vv eu
painvu	pp in vv uu
pamem	pp aa mm ai mm
pami	pp aa mm ii
pampou	pp an pp ou
pam�m	pp aa mm ai mm
pani	pp aa nn ii
paniou	pp aa nn yy ou
pankli	pp an kk ll ii
pansin	pp an ss in
panso	pp an ss au
parfeu	pp aa rr ff eu
parmou	pp aa rr mm ou
parno	pp aa rr nn au
parpa	pp aa rr pp aa
pastem	pp aa ss tt ai mm
past�m	pp aa ss tt ai mm
pava	pp aa vv aa
paveu	pp aa vv eu
paweu	pp aa ww eu
pchindin	pp ch in dd in
pegzl�	pp ai gg zz ll ei
peillo	pp ai yy au
peinu	pp ai nn uu
penchin	pp an ch in
penio	pp ee nn yy au
peniou	pp ee nn yy ou
penva	pp an vv aa
percuium	pp ai rr kk uy yy oo mm
perfa	pp ai rr ff aa
pesco	pp ai ss kk au
peuepu	pp eu pp uu
peufeu	pp eu ff eu
peuha	pp eu aa
peuneu	pp eu nn eu
peuni	pp eu nn ii
peunium	pp eu nn yy oo mm
peupa	pp eu pp aa
peurfeu	pp oe rr ff eu
peussem	pp oe ss ai mm
peuva	pp eu vv aa
peuveu	pp eu vv eu
pfazi	pp ff aa zz ii
pfeuhin	pp ff eu in
pfeumeu	pp ff eu mm eu
pfeusa	pp ff eu zz aa
pfeuva	pp ff eu vv aa
pfinhin	pp ff ii nn in
pfrougla	pp ff rr ou gg ll aa
pfuhin	pp ff uu in
pfuva	pp ff uu vv aa
pfuvin	pp ff uu vv in
pfuvu	pp ff uu vv uu
piabu	pp yy aa bb uu
piajeu	pp yy aa jj eu
picha	pp ii ch aa
picti	pp ii kk tt ii
piemba	pp yy an bb aa
pifli	pp ii ff ll ii
pifu	pp ii ff uu
pigain	pp ii gg in
pigou	pp ii gg ou
piguin	pp ii gg in
pijin	pp ii jj in
pinblou	pp in bb ll ou
pinchi	pp in ch ii
pindouin	pp in dd ww in
pinfla	pp in ff ll aa
pingo	pp in gg au
pinla	pp in ll aa
pinlo	pp in ll au
pinro	pp in rr au
pinto	pp in tt au
pinu	pp ii nn uu
pinva	pp in vv aa
pinveu	pp in vv eu
pipa	pp ii pp aa
pivou	pp ii vv ou
placain	pp ll aa kk in
plafo	pp ll aa ff au
plakin	pp ll aa kk in
plali	pp ll aa ll ii
planblo	pp ll an bb ll au
plancha	pp ll an ch aa
planfa	pp ll an ff aa
planga	pp ll an gg aa
planki	pp ll an kk ii
planko	pp ll an kk au
plansan	pp ll an ss an
plansou	pp ll an ss ou
plapta	pp ll aa pp tt aa
plarnam	pp ll aa rr nn aa mm
plasson	pp ll aa ss on
plastem	pp ll aa ss tt ai mm
plasu	pp ll aa zz uu
plertam	pp ll ai rr tt aa mm
plicha	pp ll ii ch aa
plido	pp ll ii dd au
plifan	pp ll ii ff an
plima	pp ll ii mm aa
plinbin	pp ll in bb in
plinfin	pp ll in ff in
plinhin	pp ll ii nn in
plinif	pp ll ii nn ii ff
plinpin	pp ll in pp in
plinrin	pp ll in rr in
plinsu	pp ll in ss uu
plinvri	pp ll in vv rr ii
plocrou	pp ll oo kk rr ou
plopin	pp ll oo pp in
ploufon	pp ll ou ff on
plouhin	pp ll ou in
ploulo	pp ll ou ll au
ploupin	pp ll ou pp in
plouri	pp ll ou rr ii
plovu	pp ll oo vv uu
plufin	pp ll uu ff in
plufri	pp ll uu ff rr ii
plufu	pp ll uu ff uu
plujo	pp ll uu jj au
plujour	pp ll uu jj ou rr
pluli	pp ll uu ll ii
plumlou	pp ll un ll ou
plumlu	pp ll un ll uu
plurfin	pp ll uu rr ff in
plurji	pp ll uu rr jj ii
pl�st�m	pp ll ai ss tt ai mm
pl�cha	pp ll ei ch aa
pl�tu	pp ll ei tt uu
pl�ya	pp ll ei yy aa
pl�yin	pp ll ei yy in
pobi	pp oo bb ii
pocssin	pp oo kk ss in
podi	pp oo dd ii
podru	pp oo dd rr uu
poglin	pp oo gg ll in
poirtu	pp ww aa rr tt uu
ponma	pp on mm aa
ponmi	pp on mm ii
ponni	pp oo nn ii
ponou	pp oo nn ou
popu	pp oo pp uu
porfou	pp oo rr ff ou
porjlo	pp oo rr jj ll au
pornu	pp oo rr nn uu
poroir	pp oo rr ww aa rr
porssu	pp oo rr ss uu
poru	pp oo rr uu
porvnu	pp oo rr vv nn uu
poubrou	pp ou bb rr ou
pouchi	pp ou ch ii
pouga	pp ou gg aa
pouglu	pp ou gg ll uu
pouja	pp ou jj aa
poulmou	pp ou ll mm ou
poulou	pp ou ll ou
poumi	pp ou mm ii
poumon	pp ou mm on
pouni	pp ou nn ii
poupson	pp ou pp ss on
pourdan	pp ou rr dd an
poursin	pp ou rr ss in
pourvu	pp ou rr vv uu
praclu	pp rr aa kk ll uu
practou	pp rr aa kk tt ou
praga	pp rr aa gg aa
praktou	pp rr aa kk tt ou
praprin	pp rr aa pp rr in
prarco	pp rr aa rr kk au
praro	pp rr aa rr au
prarou	pp rr aa rr ou
prasta	pp rr aa ss tt aa
pratan	pp rr aa tt an
prebi	pp rr ee bb ii
prefou	pp rr ee ff ou
preka	pp rr ee kk aa
prenprin	pp rr an pp rr in
prenrdon	pp rr an rr dd on
prenvin	pp rr an vv in
preurnu	pp rr oe rr nn uu
previn	pp rr ee vv in
pribou	pp rr ii bb ou
pribru	pp rr ii bb rr uu
pridi	pp rr ii dd ii
prilu	pp rr ii ll uu
prinbin	pp rr in bb in
princha	pp rr in ch aa
princou	pp rr in kk ou
prinfu	pp rr in ff uu
prinin	pp rr ii nn in
prinzi	pp rr in zz ii
priscan	pp rr ii ss kk an
priskan	pp rr ii ss kk an
pri�rtam	pp rr ii yy ai rr tt aa mm
procha	pp rr oo ch aa
prochan	pp rr oo ch an
profo	pp rr oo ff au
progri	pp rr oo gg rr ii
projan	pp rr oo jj an
projen	pp rr oo jj ai nn
prordo	pp rr oo rr dd au
prossan	pp rr oo ss an
proto	pp rr oo tt au
prouchan	pp rr ou ch an
prougla	pp rr ou gg ll aa
prouilla	pp rr ou yy aa
prouvi	pp rr ou vv ii
proxo	pp rr oo kk ss au
prubran	pp rr uu bb rr an
prugla	pp rr uu gg ll aa
pruru	pp rr uu rr uu
pruss�m	pp rr uu ss ai mm
pruta	pp rr uu tt aa
pr�speu	pp rr ai ss pp eu
pr�glo	pp rr ei gg ll au
pr�guin	pp rr ei gg in
pr�niou	pp rr ei nn yy ou
psaga	pp ss aa gg aa
psanpou	pp ss an pp ou
psanso	pp ss an ss au
psasa	pp ss aa zz aa
pseltu	pp ss ai ll tt uu
pserman	pp ss ai rr mm an
psermen	pp ss ai rr mm ai nn
pseunou	pp ss eu nn ou
psigra	pp ss ii gg rr aa
psika	pp ss ii kk aa
psingu	pp ss in gg uu
psipo	pp ss ii pp au
psirva	pp ss ii rr vv aa
psitrin	pp ss ii tt rr in
psiyou	pp ss ii yy ou
psojan	pp ss oo jj an
psojen	pp ss oo jj ai nn
psorba	pp ss oo rr bb aa
psorvou	pp ss oo rr vv ou
psounian	pp ss ou nn yy an
psuptou	pp ss uu pp tt ou
psurtout	pp ss uu rr tt ou
psuta	pp ss uu tt aa
ps�lo	pp ss ei ll au
ps�lou	pp ss ei ll ou
ps�no	pp ss ei nn au
pubru	pp uu bb rr uu
pugnoum	pp uu nn yy ou mm
pulin	pp uu ll in
pupti	pp uu pp tt ii
puran	pp uu rr an
puria	pp uu rr yy aa
purtu	pp uu rr tt uu
puscou	pp uu ss kk ou
pussi	pp uu ss ii
puto	pp uu tt au
puzu	pp uu zz uu
pvivoua	pp vv ii vv ou aa
pvorv�	pp vv oo rr vv ei
pziyou	pp zz ii yy ou
p�cheu	pp ei ch eu
p�fou	pp ei ff ou
p�mu	pp ei mm uu
p�pin	pp ei pp in
p�r�	pp ei rr ei
p�sseu	pp ei ss eu
p�vou	pp ei vv ou
p�zu	pp ei zz uu
quecrin	kk ee kk rr in
quepa	kk ee pp aa
querjin	kk ai rr jj in
quimki	kk in kk ii
quinpu	kk in pp uu
qu�mi	kk ei mm ii
qu�ti	kk ei tt ii
raclou	rr aa kk ll ou
ragru	rr aa gg rr uu
raguin	rr aa gg in
ramgu	rr an gg uu
rampran	rr an pp rr an
rancha	rr an ch aa
randa	rr an dd aa
ranpran	rr an pp rr an
ranto	rr an tt au
ranu	rr aa nn uu
rareum	rr aa rr eu mm
refu	rr ee ff uu
rembi	rr an bb ii
remou	rr ee mm ou
reso	rr ee ss au
reufeu	rr eu ff eu
reugui	rr eu gg ii
reuma	rr eu mm aa
reuveu	rr eu vv eu
rev�	rr ee vv ei
riarm	rr yy aa rr mm ee
ricou	rr ii kk ou
ridou	rr ii dd ou
rimbi	rr in bb ii
rimbin	rr in bb in
rina	rr ii nn aa
rinbi	rr in bb ii
rinbin	rr in bb in
rincho	rr in ch au
rinflu	rr in ff ll uu
rinfu	rr in ff uu
ringuan	rr in gg an
ringzan	rr in gg zz an
rinou	rr ii nn ou
rinrin	rr in rr in
rinseu	rr in ss eu
rinto	rr in tt au
rinza	rr in zz aa
riou	rr yy ou
rirbo	rr ii rr bb au
rirjo	rr ii rr jj au
rirni	rr ii rr nn ii
rissu	rr ii ss uu
rivrin	rr ii vv rr in
rivu	rr ii vv uu
rochon	rr oo ch on
rogu	rr oo gg uu
roma	rr oo mm aa
rompu	rr on pp uu
ronron	rr on rr on
ronsan	rr on ss an
rorjdo	rr oo rr jj dd au
roro	rr oo rr au
rouban	rr ou bb an
roudin	rr ou dd in
rouflou	rr ou ff ll ou
rougin	rr ou jj in
rouilli	rr ou yy ii
rounia	rr ou nn yy aa
roussan	rr ou ss an
rouvin	rr ou vv in
rouzan	rr ou zz an
rucha	rr uu ch aa
rucou	rr uu kk ou
ruera	rr uy rr aa
rugno	rr uu nn yy au
rugou	rr uu gg ou
ruizpa	rr uy ii zz pp aa
rukin	rr uu kk in
rukou	rr uu kk ou
ruman	rr uu mm an
rumeau	rr uu mm au
rumo	rr uu mm au
rumpa	rr un pp aa
runa	rr uu nn aa
runio	rr uu nn yy au
runou	rr uu nn ou
rurcu	rr uu rr kk uu
ruspa	rr uu ss pp aa
ruvo	rr uu vv au
r�rchan	rr ai rr ch an
r�po	rr ei pp au
r�rcha	rr ei rr ch aa
sabo	ss aa bb au
sacou	ss aa kk ou
sacta	ss aa kk tt aa
sadin	ss aa dd in
sagneu	ss aa nn yy eu
sakou	ss aa kk ou
saltu	ss aa ll tt uu
salu	ss aa ll uu
samfro	ss an ff rr au
samsu	ss an ss uu
sanfin	ss an ff in
sanga	ss an gg aa
sangan	ss an gg an
sangu	ss an gg uu
sanguin	ss an gg in
saniou	ss aa nn yy ou
sanjo	ss an jj au
sanju	ss an jj uu
saptin	ss aa pp tt in
sara	ss aa rr aa
saran	ss aa rr an
sasi	ss aa zz ii
saya	ss ai yy aa
sayin	ss ai yy in
sayun	ss ai yy un
scabin	ss kk aa bb in
scachu	ss kk aa ch uu
scafli	ss kk aa ff ll ii
scalu	ss kk aa ll uu
scampra	ss kk an pp rr aa
scanfran	ss kk an ff rr an
scardo	ss kk aa rr dd au
scinscan	ss in ss kk an
scocsan	ss kk oo kk ss an
scougo	ss kk ou gg au
scurba	ss kk uu rr bb aa
scusto	ss kk uu ss tt au
sc�pin	ss ss ei pp in
segu�	ss ee gg ei
semveu	ss an vv eu
senfin	ss an ff in
serma	ss ai rr mm aa
sespan	ss ai ss pp an
sestan	ss ai ss tt an
siclu	ss ii kk ll uu
sicou	ss ii kk ou
sicro	ss ii kk rr au
sienveu	ss yy an vv eu
sifa	ss ii ff aa
sijo	ss ii jj au
sikou	ss ii kk ou
sil	SIL
simblan	ss in bb ll an
simu	ss ii mm uu
sinca	ss in kk aa
sincro	ss in kk rr au
sinfa	ss in ff aa
singlu	ss in gg ll uu
sinmou	ss in mm ou
sinou	ss ii nn ou
sinra	ss in rr aa
sinsa	ss in ss aa
sinsi	ss in ss ii
sintou	ss in tt ou
sinu	ss ii nn uu
sirva	ss ii rr vv aa
sisan	ss ii zz an
siscou	ss ii ss kk ou
sisi	ss ii zz ii
siski	ss ii ss kk ii
siskou	ss ii ss kk ou
sissa	ss ii ss aa
skafli	ss kk aa ff ll ii
skamo	ss kk aa mm au
skanvan	ss kk an vv an
skavu	ss kk aa vv uu
skerbu	ss kk ai rr bb uu
skigu	ss kk ii gg uu
skincho	ss kk in ch au
skinia	ss kk ii nn yy aa
skinpin	ss kk in pp in
skinskan	ss kk in ss kk an
skiski	ss kk ii ss kk ii
skitan	ss kk ii tt an
skiti	ss kk ii tt ii
skiyin	ss kk ii yy in
skoksan	ss kk oo kk ss an
skoudan	ss kk ou dd an
skouri	ss kk ou rr ii
skovan	ss kk oo vv an
skursi	ss kk uu rr ss ii
skusto	ss kk uu ss tt au
skuto	ss kk uu tt au
sk�pin	ss kk ei pp in
sk�vo	ss kk ei vv au
sochi	ss oo ch ii
sociem	ss oo ss yy ai mm
sodin	ss oo dd in
solpri	ss oo ll pp rr ii
somon	ss oo mm on
somu	ss oo mm uu
sonin	ss oo nn in
sorbin	ss oo rr bb in
sortou	ss oo rr tt ou
soubou	ss ou bb ou
souglou	ss ou gg ll ou
souilli	ss ou yy ii
soujo	ss ou jj au
soulli	ss ou ll ii
souna	ss ou nn aa
sourin	ss ou rr in
soutbrin	ss ou tt bb rr in
souti	ss ou tt ii
souza	ss ou zz aa
spabou	ss pp aa bb ou
spaintu	ss pp in tt uu
spaku	ss pp aa kk uu
spanbin	ss pp an bb in
spangu	ss pp an gg uu
spania	ss pp aa nn yy aa
sparna	ss pp aa rr nn aa
specteu	ss pp ai kk tt eu
spectu	ss pp ai kk tt uu
spelu	ss pp ee ll uu
spenbin	ss pp an bb in
spenso	ss pp an ss au
spilpra	ss pp ii ll pp rr aa
spima	ss pp ii mm aa
spimo	ss pp ii mm au
spimon	ss pp ii mm on
spinc	ss pp in
spindou	ss pp in dd ou
spinpson	ss pp in pp ss on
spintrin	ss pp in tt rr in
spinu	ss pp ii nn uu
spiprou	ss pp ii pp rr ou
spipsso	ss pp ii pp ss au
spirba	ss pp ii rr bb aa
spiski	ss pp ii ss kk ii
spiyou	ss pp ii yy ou
spofo	ss pp oo ff au
spogo	ss pp oo gg au
sponu	ss pp oo nn uu
sporo	ss pp oo rr au
spotu	ss pp oo tt uu
spounian	ss pp ou nn yy an
spoura	ss pp ou rr aa
spourgou	ss pp ou rr gg ou
spousco	ss pp ou ss kk au
spou�	ss pp ou ei
spovu	ss pp oo vv uu
spulu	ss pp uu ll uu
spuna	ss pp uu nn aa
spupra	ss pp uu pp rr aa
spusa	ss pp uu zz aa
spussa	ss pp uu ss aa
sp�ncu	ss pp ai nn kk uu
sp�bin	ss pp ei bb in
sp�lo	ss pp ei ll au
sp�no	ss pp ei nn au
sp�r	ss pp ei rr
sp�ra	ss pp ei rr aa
sp�tu	ss pp ei tt uu
stachu	ss tt aa ch uu
stacti	ss tt aa kk tt ii
stado	ss tt aa dd au
stafra	ss tt aa ff rr aa
stafrin	ss tt aa ff rr in
stakti	ss tt aa kk tt ii
stanfi	ss tt an ff ii
stanka	ss tt an kk aa
stanki	ss tt an kk ii
stanpan	ss tt an pp an
starma	ss tt aa rr mm aa
starvya	ss tt aa rr vv yy aa
staspu	ss tt aa ss pp uu
stema	ss tt ee mm aa
stenca	ss tt an kk aa
stenfi	ss tt an ff ii
stenka	ss tt an kk aa
stenspi	ss tt an ss pp ii
steupsan	ss tt eu pp ss an
stigi	ss tt ii jj ii
stiji	ss tt ii jj ii
stikta	ss tt ii kk tt aa
stinka	ss tt in kk aa
stinspi	ss tt in ss pp ii
stirba	ss tt ii rr bb aa
stodu	ss tt oo dd uu
stogza	ss tt oo gg zz aa
stoju	ss tt oo jj uu
stoj�	ss tt oo jj ei
stonu	ss tt oo nn uu
stopsan	ss tt oo pp ss an
storgia	ss tt oo rr jj yy aa
storvo	ss tt oo rr vv au
stoucho	ss tt ou ch au
stoudu	ss tt ou dd uu
stoumo	ss tt ou mm au
stouni	ss tt ou nn ii
stourka	ss tt ou rr kk aa
stuman	ss tt uu mm an
stumou	ss tt uu mm ou
stupi	ss tt uu pp ii
sturpou	ss tt uu rr pp ou
sturtu	ss tt uu rr tt uu
stutu	ss tt uu tt uu
sucsan	ss uu kk ss an
sukso	ss uu kk ss au
sultu	ss uu ll tt uu
sumant	ss uu mm an
sumen	ss uu mm ai nn
sumi	ss uu mm ii
suno	ss uu nn au
supso	ss uu pp ss au
surpu	ss uu rr pp uu
susan	ss uu zz an
suvu	ss uu vv uu
suzeu	ss uu zz eu
suzu	ss uu zz uu
s�mi	ss ei mm ii
s�mou	ss ei mm ou
s�nieu	ss ei nn yy eu
s�nu	ss ei nn uu
taclou	tt aa kk ll ou
tadru	tt aa dd rr uu
taga	tt aa gg aa
tagno	tt aa nn yy au
tahin	tt aa in
tamfam	tt an ff aa mm
tampsa	tt an pp ss aa
tampsin	tt an pp ss in
tanchin	tt an ch in
tani	tt aa nn ii
tanio	tt aa nn yy au
tanrko	tt an rr kk au
tansi	tt an ss ii
tchipson	tt ch ii pp ss on
tchitrou	tt ch ii tt rr ou
techtu	tt ai kk tt uu
teill�	tt ai yy ei
telque	tt ai ll kk ee
temtu	tt an tt uu
tena	tt ee nn aa
tenrco	tt an rr kk au
tensi	tt an ss ii
terda	tt ai rr dd aa
termaim	tt ai rr mm in
tersou	tt ai rr ss ou
teuyoum	tt eu yy ou mm
tiban	tt ii bb an
tichu	tt ii ch uu
tifa	tt ii ff aa
tifou	tt ii ff ou
tignou	tt ii nn yy ou
tikso	tt ii kk ss au
tillou	tt ii yy ou
timfla	tt in ff ll aa
tinchu	tt in ch uu
tingnan	tt in nn yy an
tinheu	tt ii nn eu
tinian	tt ii nn yy an
tinio	tt ii nn yy au
tinjo	tt in jj au
tinla	tt in ll aa
tinsan	tt in ss an
tinzin	tt in zz in
tisa	tt ii zz aa
tisso	tt ii ss au
tiva	tt ii vv aa
tivi	tt ii vv ii
tivu	tt ii vv uu
tj�ni	tt jj ei nn ii
toblou	tt oo bb ll ou
tofan	tt oo ff an
tofou	tt oo ff ou
toissou	tt ww aa ss ou
toki	tt oo kk ii
toli	tt oo ll ii
torji	tt oo rr jj ii
torka	tt oo rr kk aa
torou	tt oo rr ou
toubu	tt ou bb uu
toudou	tt ou dd ou
tougui	tt ou gg ii
touilli	tt ou yy ii
toulna	tt ou ll nn aa
touna	tt ou nn aa
tourglu	tt ou rr gg ll uu
tourka	tt ou rr kk aa
toussu	tt ou ss uu
tousu	tt ou zz uu
toxi	tt oo kk ss ii
traclin	tt rr aa kk ll in
tracsu	tt rr aa kk ss uu
traga	tt rr aa gg aa
traguin	tt rr aa gg in
tranda	tt rr an dd aa
tranfi	tt rr an ff ii
trasu	tt rr aa zz uu
trechou	tt rr ee ch ou
triblo	tt rr ii bb ll au
triblu	tt rr ii bb ll uu
tribu	tt rr ii bb uu
triclu	tt rr ii kk ll uu
triklu	tt rr ii kk ll uu
trilu	tt rr ii ll uu
trimon	tt rr ii mm on
trinia	tt rr ii nn yy aa
trinlo	tt rr in ll au
trintin	tt rr in tt in
trinvin	tt rr in vv in
tripou	tt rr ii pp ou
tromin	tt rr oo mm in
tronu	tt rr oo nn uu
tropson	tt rr oo pp ss on
trorma	tt rr oo rr mm aa
trormo	tt rr oo rr mm au
trormou	tt rr oo rr mm ou
troucho	tt rr ou ch au
troufu	tt rr ou ff uu
trourpi	tt rr ou rr pp ii
trufru	tt rr uu ff rr uu
trukjou	tt rr uu kk jj ou
truvrin	tt rr uu vv rr in
truzou	tt rr uu zz ou
tr�chou	tt rr ei ch ou
tr�dri	tt rr ei dd rr ii
tr�ga	tt rr ei gg aa
tr�gan	tt rr ei gg an
tr�mon	tt rr ei mm on
tr�tu	tt rr ei tt uu
tr�vin	tt rr ei vv in
tsasto	tt ss aa ss tt au
tufeu	tt uu ff eu
tunia	tt uu nn yy aa
tunu	tt uu nn uu
tupa	tt uu pp aa
tusu	tt uu zz uu
tutran	tt uu tt rr an
t�gne	tt ai nn yy
t�mbu	tt ai mm bb uu
t�bla	tt ei bb ll aa
t�blan	tt ei bb ll an
t�bri	tt ei bb rr ii
t�dan	tt ei dd an
t�fi	tt ei ff ii
t�ga	tt ei gg aa
t�gui	tt ei gg ii
t�guin	tt ei gg in
t�io	tt ei yy au
t�ka	tt ei kk aa
t�ki	tt ei kk ii
t�rou	tt ei rr ou
t�si	tt ei zz ii
t�tin	tt ei tt in
t�yo	tt ei yy au
vaban	vv aa bb an
vabane	vv aa bb aa nn
vachin	vv aa ch in
vadin	vv aa dd in
vaelu	vv ai ll uu
vafa	vv aa ff aa
vafeu	vv aa ff eu
vafi	vv aa ff ii
vafin	vv aa ff in
vaheu	vv aa eu
vailli	vv aa yy ii
vaillu	vv aa yy uu
vainfeu	vv in ff eu
valchi	vv aa ll ch ii
vamfeu	vv an ff eu
vampton	vv an pp tt on
vanfa	vv an ff aa
vanfou	vv an ff ou
vanheu	vv aa nn eu
vania	vv aa nn yy aa
vanion	vv aa nn yy on
vanrnu	vv an rr nn uu
vanu	vv aa nn uu
vanvo	vv an vv au
varban	vv aa rr bb an
varchi	vv aa rr ch ii
varda	vv aa rr dd aa
varin	vv aa rr in
varou	vv aa rr ou
varvnu	vv aa rr vv nn uu
vasteu	vv aa ss tt eu
vastin	vv aa ss tt in
vata	vv aa tt aa
vatu	vv aa tt uu
vava	vv aa vv aa
vavain	vv aa vv in
vaveu	vv aa vv eu
vavin	vv aa vv in
vayu	vv ai yy uu
veillo	vv ai yy au
venfa	vv an ff aa
venfou	vv an ff ou
venpsa	vv an pp ss aa
venrnu	vv an rr nn uu
venton	vv an tt on
verheu	vv ee rr eu
versi	vv ai rr ss ii
vertu	vv ai rr tt uu
vesu	vv ee zz uu
veuaheu	vv eu aa eu
veubain	vv eu bb in
veucheu	vv eu ch eu
veuchou	vv eu ch ou
veuchu	vv eu ch uu
veufa	vv eu ff aa
veufeu	vv eu ff eu
veufo	vv eu ff au
veufou	vv eu ff ou
veugnem	vv eu nn yy ai mm
veuheu	vv eu eu
veuhin	vv eu in
veuja	vv eu jj aa
veujam	vv eu jj aa mm
veulu	vv eu ll uu
veulun	vv eu ll un
veuma	vv eu mm aa
veumain	vv eu mm in
veupeu	vv eu pp eu
veurfeu	vv oe rr ff eu
veusum	vv eu zz oo mm
veuva	vv eu vv aa
veuveu	vv eu vv eu
veuvin	vv eu vv in
veuv�m	vv eu vv ai mm
veuv�n	vv eu vv ai nn
veu�di	vv eu ei dd ii
veve	vv ee vv
viam�n	vv yy aa mm ai nn
vichin	vv ii ch in
vidin	vv ii dd in
vienbin	vv yy in bb in
vienbo	vv yy in bb au
vienheu	vv yy in eu
vifi	vv ii ff ii
vihan	vv yy an
viheu	vv yy eu
vihin	vv yy in
vika	vv ii kk aa
vinfa	vv in ff aa
vinfeu	vv in ff eu
vinfin	vv in ff in
vingra	vv in gg rr aa
vinhim	vv ii nn ii mm
vinjou	vv in jj ou
vinleu	vv in ll eu
vinlou	vv in ll ou
vinlu	vv in ll uu
vinmeu	vv in mm eu
vinmi	vv in mm ii
vinou	vv ii nn ou
vinva	vv in vv aa
vinveu	vv in vv eu
vinzu	vv in zz uu
viorpin	vv yy oo rr pp in
vipou	vv ii pp ou
viuhin	vv yy uu in
viveu	vv ii vv eu
vivin	vv ii vv in
vivu	vv ii vv uu
vochi	vv oo ch ii
vocta	vv oo kk tt aa
vogsi	vv oo gg ss ii
vori	vv oo rr ii
vosso	vv oo ss au
voufli	vv ou ff ll ii
voufo	vv ou ff au
vougu	vv ou gg uu
vouillan	vv ou yy an
vouillant	vv ou yy an
vouja	vv ou jj aa
vouksi	vv ou kk ss ii
vouna	vv ou nn aa
vounian	vv ou nn yy an
vouniou	vv ou nn yy ou
vouniour	vv ou nn yy ou rr
voupin	vv ou pp in
voupti	vv ou pp tt ii
vouptil	vv ou pp tt ii ll
voussan	vv ou ss an
vousso	vv ou ss au
vouzan	vv ou zz an
vranlou	vv rr an ll ou
vreuveu	vv rr eu vv eu
vrumu	vv rr uu mm uu
vr�	vv rr ei
vuchu	vv uu ch uu
vufa	vv uu ff aa
vuhin	vv uu in
vuji	vv uu jj ii
vuju	vv uu jj uu
vulin	vv uu ll in
vultin	vv uu ll tt in
vulu	vv uu ll uu
vuneu	vv uu nn eu
vuni	vv uu nn ii
vunin	vv uu nn in
vurpin	vv uu rr pp in
vurtan	vv uu rr tt an
vurvo	vv uu rr vv au
vusu	vv uu zz uu
v�cli	vv ei kk ll ii
v�fa	vv ei ff aa
v�f�	vv ei ff ei
v�gna	vv ei nn yy aa
v�ha	vv ei aa
v�kli	vv ei kk ll ii
v�nia	vv ei nn yy aa
v�ta	vv ei tt aa
v�veu	vv ei vv eu
xampi	kk ss an pp ii
xuva	kk ss uu vv aa
x�msen	kk ss ei mm ss ai nn
yamcheu	yy an ch eu
yamp�	yy an pp ei
yani	yy aa nn ii
yanian	yy aa nn yy an
yanja	yy an jj aa
yanpla	yy an pp ll aa
yanrbo	yy an rr bb au
yatrain	yy aa tt rr in
yenbin	yy an bb in
yenfam	yy an ff aa mm
yenja	yy an jj aa
yera	yy rr aa
yerjo	yy ai rr jj au
yeudru	yy eu dd rr uu
yeuvchu	yy oe vv ch uu
yichu	yy ii ch uu
yigan	yy ii gg an
yigu	yy ii gg uu
yioucou	yy ou kk ou
yodru	yy oo dd rr uu
yomu	yy oo mm uu
yormu	yy oo rr mm uu
youbou	yy ou bb ou
yovu	yy oo vv uu
yucam	yy uu kk aa mm
yucten	yy uu kk tt ai nn
yufli	yy uu ff ll ii
yujo	yy uu jj au
yuktan	yy uu kk tt an
yumtu	yy un tt uu
y�ba	yy ei bb aa
y�bri	yy ei bb rr ii
y�mi	yy ei mm ii
y�mon	yy ei mm on
y�ssi	yy ei ss ii
y�zim	yy ei zz ii mm
zachin	zz aa ch in
zacrin	zz aa kk rr in
zadi	zz aa dd ii
zaflu	zz aa ff ll uu
zaha	zz aa aa
zajan	zz aa jj an
zala	zz aa ll aa
zaldi	zz aa ll dd ii
zalu	zz aa ll uu
zamfli	zz an ff ll ii
zandro	zz an dd rr au
zanfrin	zz an ff rr in
zanro	zz an rr au
zansi	zz an ss ii
zara	zz aa rr aa
zarmu	zz aa rr mm uu
zaslu	zz aa ss ll uu
zasoo	zz aa zz ou
zavin	zz aa vv in
zenan	zz ee nn an
zendrin	zz an dd rr in
zenpi	zz an pp ii
zensi	zz an ss ii
zerba	zz ai rr bb aa
zerjan	zz ai rr jj an
zidu	zz ii dd uu
zimi	zz ii mm ii
zinju	zz in jj uu
zinsu	zz in ss uu
zintin	zz in tt in
zinvo	zz in vv au
zioupi	zz yy ou pp ii
zitin	zz ii tt in
zito	zz ii tt au
ziyou	zz ii yy ou
zizou	zz ii zz ou
zobeu	zz oo bb eu
zocha	zz oo ch aa
zochi	zz oo ch ii
zora	zz oo rr aa
zougo	zz ou gg au
zouman	zz ou mm an
zoumen	zz ou mm ai nn
zoumi	zz ou mm ii
zoumou	zz ou mm ou
zoumu	zz ou mm uu
zouplin	zz ou pp ll in
zouru	zz ou rr uu
zousi	zz ou zz ii
zouvin	zz ou vv in
zova	zz oo vv aa
zp�su	zz pp ss uu
zubu	zz uu bb uu
zufrin	zz uu ff rr in
zulia	zz uu ll yy aa
zumou	zz uu mm ou
zuniou	zz uu nn yy ou
zupi	zz uu pp ii
zupou	zz uu pp ou
zussi	zz uu ss ii
zuvo	zz uu vv au
zuza	zz uu zz aa
z�drou	zz ei dd rr ou
z�gna	zz ei nn yy aa
z�gro	zz ei gg rr au
z�meu	zz ei mm eu
z�na	zz ei nn aa
z�ta	zz ei tt aa
�roui	ei rr ou ii 